PLINY ε NATURAL HISTORY

lana XXV et priore libro XXXV: LX. oesypo
XX et priore libro XXXII = LII, mulis V et priore
libro I= VI, caballis III et priore libro I= ’χ IV,
cane XLI et priore libro XVI = '³‘ LVII, cane
rabioso II et priore III = V, viverra Ι, mure XXVIII
et priore libro XIV = LXII, mure araneo I et
priore libro IV = V, glire VI et priore libro II =
VIII, sorice II et priore libro Ι = III, mustela XXV
et priore libro XIX = XLIV, stellione XII et
priore libro IV = XVI, erinaceo XIII et priore
libro V = XVIII, hystrice II et priore libro Ι = III,
lacerta XXX et priore libro XIII= XLIII, sala-
mandra III et priore libro I= IV, coclea XIX et
priore libro XXVII = XLVI (xliii ageraton 1 medica-
mentum), aspide III et priore libro I = IV, dracone
VI et priore libro IV= X, vipera XXI et priore
libro XIV = XXXV, angue XXVII et priore libro
VIII = XXXV, bova III e’c priore libro IV = VII,
enhydride II et priore libro I = III, amphisbaena
III, serpentibus ceteris VII et priore libro VIII = XV
scorpione II et priore libro IV= VI, araneorum
et phalangiorum genera ’ἓ XII, medicinae XXVII et
priore libro IX = XXXVI, 'croxalide III, phryganione
I, scolopendra sive multipeda sive millepeda sive
centipeda sive onisco sive iulo XX et priore libro
I = XXI, (admiratio naturae nihil sine usu gignentis),
limace III et priore libro I = IV, uruca II et priore
libro 1: III, verme terreno XX et priore libro
II = XXII, verme ex arboribus IV ei: priore libro
I= V, verme ex herba VIII, herpete I, ricino III,
ex volucribus aquila ΙΙΙ et priore libro 1V= VII,
volture VII et priore libro IX = XVI, ossifrago VI,
gallinaceo XXXV et priore libro XXI Ξ LVI,
gallina *XXII et priore libro X=XXXII‚ ovis

136

